###############
#######     ###
##   ## ##   ##
####   s## ####
###  ####  ####
##  ###   #####
#######e#######