###############
#####         #
###   ####### #
### ###  #    #
##   ## ##   ##
####    ## ####
###  ####  ####
##s ###   #####
#######e#######