#########################e#########################
#                                   # #           #
# # ### ### ################### ##### # # # # # ###
# # #   # #   #   # # #                 # # # #   #
##### # # ### # ### # # ### ### # ##### ### #######
#     # #   # #     #   # # #   #     # # #       #
### ####### # ##### ### # # ####### # ### # ### # #
# #     #     #   #     #     #     # #       # # #
# # ########### # ######### # ####### # ### # #####
#     # #   # # #     #     # #   #   # #   #     #
# ##### # ### # ##### ### ### # # # ####### ##### #
# #     #   # # #       # # #   # # # #   #     # #
# # ##### ### ### ### ### # ##### ### ### ##### ###
#     #   # # #     # #       # #       # #     # #
# # ##### # # # ### # ### ##### ### ##### ### # # #
# # #           #   # #   #     #     #     # #   #
# ####### ####### # ### ####### ### # # ######### #
#   #       #     # #   #         # # # #     #   #
### # # ##### # ##### ####### ####### # # # # # ###
#     #   #   #         #       # #   # # # # #   #
### # ### # ### ##### ####### # # # ### ### # ### #
# # # # # # # #     # # #     #       #   # # # # #
# # ### # # # ### ### # # ######### ##### # # # # #
# # #   # # #     #   # #s  #     #   #     # # # #
# # # ### ####### ##### # ####### ### # ### ### # #
# # #     #   #   #     # #     # # # #   #   # # #
# ##### # # # ### # ##### ##### # # # ##### # # # #
# #     # # # #     # #     #           # # #   # #
# ##### # ### # ##### ########### ####### # # # # #
#     # # # #             #   #     # # #   # # # #
# # # ### # ### # ##### ##### ####### # ### # # # #
# # #   # # #   #     # #             #     # # # #
# ##### # # ########### ####### ### # ####### # # #
# #     #   #   #     # #   #   # # #       # #   #
# # # ######### # ##### # ### ### ### # ##### # ###
# # #       #           #   # # #   # #   #   #   #
# ####### ##### ####### # ### # # ### ### # #######
#   #   #   #   #   #     #         # # # # # # # #
# ##### # ### ##### # ####### # ##### # ### # # # #
#     #           #     #     # # #   #   #     # #
### ### ##################### ### ### ### ### # # #
#   #   #     #               # # #   #       #   #
### ### # ##### # ####### ### # # ### # ### ##### #
#       #       #   #   # # #   #     #   # #   # #
### ##### ##### ### ### ### ##### # # ### ### # # #
#       #   #   # # #       #   # # #   # #   #   #
### ### # ##### # ##### ### ### ### ### ####### ###
#   #     #   #   #     # # # #     # # #     #   #
# ##### ### ##### ####### # # ### ### # ### ##### #
#   #                 #           #         #     #
#########################e#########################