####################
#        #         #
# # #### ## ## ### #
#s#                #
##### ## ### # # # #
##### ##           #
#####    ## # ## # #
##### ## ## ## # # #
##### ## ##      # #
###      ## #### # #
##### ##           #
#        # # ## ####
# ### ## # # ## ####
#        # # ## ####
# ## ### ### ## ####
#                 ##
### ## # ### # ## ##
### ## # ### # ## ##
###    # ###       e
####################