####################
#        #  ## ##  #
# ###### ## ## ### #
#s#          #     #
######## ### ##### #
####  ##           #
#####    ## # #### #
########### #### # #
###########      # #
###      ## ########
########           #
#        # # ## ####
######## # # #     #
#  #     # # ## ####
#### ########## ####
#                 ##
###### # ##### ## ##
### ## # ### #### ##
###    # ###       e
####################